Actinomyces	pos
Bacillus	pos
Bavariicoccus	pos
Clostridium	pos
Corynebacterium	pos
Desulfitobacterium	pos
Enterococcus	pos
Fervidobacterium	pos
Georgenia	pos
Listeria	pos
Microbispora	pos
Nocardia	pos
Pasteuria	pos
Pilibacter	pos
Propionibacterium	pos
Rathayibacter	pos
Rhodococcus	pos
Roseburia	pos
Rothia	pos
Sarcina	pos
Solobacterium	pos
Sporosarcina	pos
Staphylococcus	pos
Strangles	pos
Streptococcus	pos
Syntrophomonas	pos
Tepidibacter	pos
Lactobacillus	pos
Leuconostoc	pos
Pediococcus	pos
Lactococcus	pos
Aerococcus	pos
Carnobacterium	pos
Oenococcus	pos
Sporolactobacillus	pos
Tetragenococcus	pos
Vagococcus	pos
Weissella	pos
Acinetobacter	neg
Agrobacterium	neg
Anaerobiospirillum	neg
Anaerolinea	neg
Arcobacter	neg
Armatimonas	neg
Azotobacter	neg
Bacteroides	neg
Bartonella	neg
Bdellovibrio	neg
Brachyspira	neg
Bradyrhizobium	neg
Caldilinea	neg
Cardiobacterium	neg
Chthonomonas	neg
Coxiella	neg
Cyanobacteria	neg
Cytophaga	neg
Dehalogenimonas	neg
Desulfurobacterium	neg
Devosia	neg
Dialister	neg
Dictyoglomus	neg
Enterobacter	neg
Escherichia	neg
Fimbriimonas	neg
Fusobacterium	neg
Haemophilus	neg
Helicobacter	neg
Klebsiella	neg
Kluyvera	neg
Kozakia	neg
Legionella	neg
Leptonema	neg
Leptotrichia	neg
Levilinea	neg
Luteimonas	neg
Megamonas	neg
Megasphaera	neg
Meiothermus	neg
Methylobacterium	neg
Moraxella	neg
Morganella	neg
Mycoplasma	neg
Negativicutes	neg
Neisseria	neg
Nitrosomonas	neg
Pectinatus	neg
Pedobacter	neg
Pelosinus	neg
Propionispora	neg
Proteobacteria	neg
Proteus	neg
Pseudomonas	neg
Pseudoxanthomonas	neg
Rickettsia	neg
Salinibacter	neg
Salmonella	neg
Samsonia	neg
Serratia	neg
Shigella	neg
Sorangium	neg
Sphaerotilus	neg
Spirochaeta	neg
Sporomusa	neg
Stenotrophomonas	neg
Thermotoga	neg
Vampirococcus	neg
Verminephrobacter	neg
Vibrio	neg
Victivallis	neg
Vitreoscilla	neg
Wolbachia	neg
Zymophilus	neg
